A=aggettivo
AP=aggettivo possessivo
B=avverbio
BN=avverbio di negazione
CC=congiunzione coordinata
CS=congiunzione subordinata
DD=aggettivo dimostrativo
DE=aggettivo esclamativo
DI=aggettivo indefinito
DQ=aggettivo interrogativo
DR=aggettivo relativo
E=preposizione
EA=preposizione articolata
FB=interpunzione
FC=interpunzione di proposizione
FF=interpunzione
FS=interpunzione di frase
I=interiezione
N=aggettivo numerale cardinale
NO=aggettivo numerale ordinale
PC=clitic pronoun
PD=pronome dimostrativo
PE=pronome personale
PI=pronome indefinito
PP=pronome possessivo
PQ=pronome interrogativo o esclamativo
PR=pronome relativo
RD=articolo determinativo
RI=articolo indeterminativo
S=nome comune
SA=abbreviazione
SP=nome proprio
T=aggettivo quantitativo
Vip=verbo indicativo presente
Vii=verbo indicativo imperfetto
Vis=verbo indicativo passato remoto
Vif=verbo indicativo futuro
Vm=verbo imperativo
Vcp=verbo congiuntivo presente
Vci=verbo congiuntivo imperfetto
Vd=verbo condizionale
Vf=verbo infinito
Vg=verbo gerundio
Vpp=verbo participio presente
Vps=verbo participio passato
VAip=verbo ausiliare indicativo presente
VAii=verbo ausiliare indicativo imperfetto
VAis=verbo ausiliare indicativo passato remoto
VAif=verbo ausiliare indicativo futuro
VAm=verbo ausiliare imperativo
VAcp=verbo ausiliare congiuntivo presente
VAci=verbo ausiliare congiuntivo imperfetto
VAd=verbo ausiliare condizionale
VAf=verbo ausiliare infinito
VAg=verbo ausiliare gerundio
VAps=verbo ausiliare participio passato
VMip=verbo modale indicativo presente
VMii=verbo modale indicativo imperfetto
VMis=verbo modale indicativo passato remoto
VMif=verbo modale indicativo futuro
VMm=verbo modale imperativo
VMcp=verbo modale congiuntivo presente
VMci=verbo modale congiuntivo imperfetto
VMd=verbo modale condizionale
VMf=verbo modale infinito
VMg=verbo modale gerundio
VMps=verbo modale participio passato
X=non classificato
